NO ./imgs/door_big3.xpm
SO ./imgs/door_slide.xpm
WE ./imgs/ironbrick.xpm
EA ./imgs/train3.xpm

C 141, 143, 145
F 210,163,209

        1111111111111111111111111
        1000000000110000000000001
        1011000001110000000000001
        1001000000000000000111001
1111111110110000011100000001 1001
10000000001100000111011111111111
11110111111111011100000010001
1111011111111101110101E010001
11000000110101011100000000001
10000000000000001100000010001
10000000000000001101010010001
1100000111010101111101111000111
11110111 1110101 101111010001
11111111 1111111 111111111111